WWWWWWWWWWWWWWWW
WWWWWWWWWWWWWWWW
WWPPPPPFFPPPPPWW
WWPFFFPPPPFFFPWW
WWPFPPPFFPPPFPDW
WWFFPFFFFFFPFFDW
WWPFPPPFFPPPFPDW
WWPFFFPPPPFFFPWW
WWPPPPPFFPPPPPWW
WWWWWWWWWWWWWWWW
WWWWWWWWWWWWWWWW
