XJJLSLJJX
XLLLJLLLX
XXLLLLLXX
XXXLSLXXX
XXLLLLLXX
XLLLLLLLX
LLLLLLLLL
LLLLLLLLL
LSLLSLLSL