BBJJJJJBB
BBBJJJBBB
BBBJJJBBB
BBBBJBBBB
BBBBBBBBB
BBBBBBBBB
XBBBBBBBX
XXBBBBBXX
XXBBBBBXX