XXRXXXRXX
XBRBXBRBX
BRRRBRRRB
BBRRRRRBB
BBRRRRRBB
XBRRRRRBX
XXBRRRBXX
XXXBRBXXX
XXXXBXXXX