XXBJJJJJJ
XBJBRBJBJ
BJJJBJBJJ
JBJBJJJBJ
JRBJBJBRJ
JBJJJBJBJ
JJBJBJJJB
JBJBRBJBX
JJJJJJBXX