JXXSXSXXJ
JJXXXXXJJ
JJJXXXJJJ
JJJJXJJJJ
JJJJJJJJJ
LSJJJJJSL
SBSJJJSBS
BBBSJSBBB
SBSLJLSBS