SRRRRRRRS
XRRRRRRRX
XRRRRRRRX
SJJJJJJJS
XJRRXRRJX
XJRRXRRJX
SJJJJJJJS
BBBXBXBBB
BJBJBJBJB