RRRRXRRRR
RRRRXRRRR
RBBRXRBBR
RJBRXRJBR
XXJBBBXJX
RJBXJXJBR
RBBRXRBBR
XXRRXRRXX
XBRRXRRBX