RRRRRRRRR
JJJJJJJJJ
BBBBBBBBB
BBBBBBBBB
XXXXXBBBB
BBBBBBBBB
BBBBBBBBB
BBBBBBBBB
BBBBBBBBB