XXXSXSXXX
XXSXLXSXX
XSXJBJXSX
SXJBLBJXS
XJBLJLBJX
JBLJLJLBJ
JLJLJLJLJ
LXLXLXLXL
JBJBJBJBJ