LLLLLLXXJ
LJJJJJXJX
LJLLLLXXX
LJLBBBBXX
LJLBBBBBX
LJLBBBBBB
XXXBBBBBB
XJXXBBBJB
JXXXXBBBJ