BJJJBJJJB
BBXBBBXBB
BBJBBBJBB
JBJBBBJBJ
JBBBBBBBJ
JBBBXBBBJ
JJBBJBBJJ
JJJBJBJJJ
BJJBBBJJB