JJJJJJJJJ
JJJJJJJJJ
JJBBBBBJJ
JJBBBBBJJ
JJBBBBBJJ
BBBBBBBBB
BBBBSBBBB
BBBBBBBBB
BBBBBBBBB