EBJJJJXXX
EBJJJJJJJ
EBJJJJJBJ
BBJJJJJJJ
XXJJJJXXX
EBJJJJXXX
EBJJJJJJJ
EBJJJJJBJ
BBJJJJJJJ