XRRRRRRRX
BRRRRRRXB
BBRRBRXBB
BBBXSXBBB
BBBBBBBBB
BBBXBXBBB
BBXBBBXBB
BXBBBBBXB
XBBBBBBBX