XBXJJJXBX
XBBSJSBBX
XBSJSJXBX
BBRRSRRBB
BBRRSRRBB
BBRRRRRBB
XBBBBBBBX
XBBBBBBBX
XBXBBBXBX