BBBXBJJJJ
BBBBBJJJJ
BBBBBJJJJ
XXXBBBBBB
BBBBBBBBB
BBBBBBBBB
BBBBBBXXX
BBBBBBSSS
BBBBBBSSS